An		- 	Miner
Tinh	-	Miner
Trong	-	King
Henrik 	-	SwordShield -	Militia Commander 
Ine 	-	SwordShield
Stian	-	Spear
Oyvor   - 	Presser/Bookbinder
Sandra 	-	Shearer/Spinner
Tord 	-	Potato -> Milker
Aslak	-	Cook
Even	-	Brewer
Arne	-	Manager
Huy		-	Beekeeper 	-	Surgeon
Thanu	-	Broker
Pedro 	-	Glazer
Marta	-	Weaver
Thoa	-	Metalsmith
Knut 	-	Hunter
Hartmann-	Gem Cutter
Ping 	-	Brewer
Salik 	-	Miller/Weaver
Earn	-	Potter
Hoa 	-	Cooker/Potato
Pham	-	Potato
Thao Vy -	Potato
Tuyen 	-	Furnace Operator
Andr√©	-	Axe
Tam		-	Xbow
Phuong	-	Xbow
Trung	-	Xbow
Linh Chi-	Clothmaker
Fast	-	Glazer
Thea	-	SwordBuckler
Vetle	-	Farmer/Potato
Janne	-	Farmer/Potato
Jonas	-	Axe
Lasse	-	Bread/Potato